25 25
100 100
16 16 16 16 16 16 16 16 16 16 16 16 16 16 16 16 16 16 16 16 16 16 16 16 16
16 19 17 17 16 16 16 16 16 16 16 16 16 16 16 16 16 16 16 16 16 16 16 16 16
16 17 17 19 16 16 16 16 16 16 16 16 16 16 16 16 16 16 16 16 16 16 16 16 16
16 16 18 16 16 16 16 16 16 16 16 16 16 16 16 16 16 16 16 16 16 16 16 16 16
16 16 18 16 16 16 16 16 16 16 16 16 16 16 16 16 16 16 16 16 16 16 16 16 16
16 16 18 16 16 16 16 16 16 16 16 16 16 16 16 16 16 16 16 16 16 16 16 16 16
16 16 18 16 16 16 16 16 16 16 16 16 16 16 16 16 16 16 16 16 16 16 16 16 16
16 16 18 16 16 16 16 16 16 16 16 16 16 16 16 16 16 16 16 16 16 16 16 16 16
16 17 19 17 17 17 17 17 17 17 17 19 17 17 17 17 17 17 17 17 17 17 17 16 16
16 17 17 17 17 17 19 17 17 17 17 17 17 17 17 17 17 17 17 17 17 17 19 16 16
16 19 17 17 17 17 17 17 17 19 17 17 17 17 17 17 17 17 17 19 17 17 17 16 16
16 17 17 17 17 17 17 17 17 17 17 17 17 17 17 17 17 17 17 17 17 17 17 16 16
16 17 17 17 17 17 17 17 17 17 17 17 17 17 17 17 17 17 17 17 17 17 19 16 16
16 19 17 17 17 17 17 17 17 17 17 17 17 17 17 17 19 17 17 17 17 17 17 16 16
16 17 17 17 17 17 17 17 17 17 17 19 17 17 17 17 17 17 17 17 17 17 17 16 16
16 17 17 17 17 17 17 17 17 17 17 17 17 17 17 17 17 17 17 17 17 17 17 16 16
16 17 17 19 17 17 17 17 17 17 17 17 17 17 17 17 17 17 17 17 19 17 17 16 16
16 17 17 17 17 17 17 17 17 17 17 17 17 17 17 17 17 17 17 17 17 17 17 16 16
16 17 17 17 17 17 17 17 17 17 17 17 17 17 17 17 17 17 17 17 17 17 17 16 16
16 16 18 16 16 16 16 16 16 16 16 16 16 16 16 16 16 16 16 16 18 16 16 16 16
16 16 18 16 16 16 16 16 16 16 16 16 16 16 16 16 16 16 16 16 18 16 16 16 16
16 16 17 17 17 17 16 16 16 16 16 16 16 16 16 16 16 16 16 16 19 17 17 17 16
16 16 17 19 17 17 16 16 16 16 16 16 16 16 16 16 16 16 16 16 17 19 17 17 16
16 16 17 17 17 17 16 16 16 16 16 16 16 16 16 16 16 16 16 16 17 17 17 17 16
16 16 16 16 16 16 16 16 16 16 16 16 16 16 16 16 16 16 16 16 16 16 18 16 16