30 30
100 100
20 20 20 20 20 20 20 20 20 20 20 20 20 20 20 20 20 20 20 20 20 20 20 20 20 20 20 20 20 20
20 20 21 21 21 20 20 20 20 20 20 20 20 20 20 20 20 20 20 20 20 20 20 20 20 20 20 20 20 20
20 20 21 21 21 20 20 20 20 21 21 21 21 21 21 21 21 21 21 21 20 20 20 20 20 20 20 20 20 20
20 20 21 21 21 20 20 20 21 21 21 21 21 21 21 21 21 21 21 21 21 20 20 20 20 20 20 20 20 20
20 20 21 21 21 20 20 21 21 21 21 21 21 21 21 21 21 21 21 21 21 21 20 20 20 20 20 20 20 20
20 20 21 21 21 20 21 21 21 21 21 21 21 21 20 21 21 21 21 21 21 21 21 20 20 20 20 20 20 20
20 20 21 21 21 21 21 21 21 21 21 21 21 20 20 20 21 21 21 21 21 21 21 21 20 20 20 20 20 20
20 20 21 21 21 21 21 21 21 21 21 21 20 20 20 20 20 21 21 21 21 21 21 21 21 20 20 20 20 20
20 20 21 21 21 21 21 21 21 21 21 20 20 20 20 20 20 20 21 21 21 21 21 21 21 21 20 20 20 20
20 20 21 21 21 21 21 21 21 21 20 20 20 20 20 20 20 20 20 21 21 21 21 21 21 21 21 20 20 20
20 20 21 21 21 21 21 21 21 20 20 20 20 20 20 20 20 20 20 20 21 21 21 21 21 21 21 21 20 20
20 20 21 21 21 21 21 21 20 20 20 20 20 20 20 20 20 20 20 20 20 21 21 21 21 21 21 21 20 20
20 20 21 21 21 21 21 20 20 20 20 20 20 20 20 20 20 20 20 20 20 20 21 21 21 21 21 21 20 20
20 20 21 21 21 21 20 20 20 20 20 20 20 20 20 20 20 20 20 20 20 20 20 21 21 21 21 21 20 20
20 20 21 21 21 20 20 20 20 20 20 20 20 20 20 20 20 20 20 20 20 20 20 20 21 21 21 21 20 20
20 20 21 21 21 21 20 20 20 20 20 20 20 20 20 20 20 20 20 20 20 20 20 21 21 21 21 21 20 20
20 20 21 21 21 21 21 20 20 20 20 20 20 20 20 20 20 20 20 20 20 20 21 21 21 21 21 21 20 20
20 20 21 21 21 21 21 21 20 20 20 20 20 20 20 20 20 20 20 20 20 21 21 21 21 21 21 21 20 20
20 20 21 21 21 21 21 21 21 20 20 20 20 20 20 20 20 20 20 20 21 21 21 21 21 21 21 21 20 20
20 20 21 21 21 21 21 21 21 21 20 20 20 20 20 20 20 20 20 21 21 21 21 21 21 21 21 21 20 20
20 20 21 21 21 21 21 21 21 21 21 20 20 20 20 20 20 20 21 21 21 21 21 21 21 21 21 20 20 20
20 20 20 21 21 21 21 21 21 21 21 21 20 20 20 20 20 21 21 21 21 21 21 21 21 21 20 20 20 20
20 20 20 20 21 21 21 21 21 21 21 21 21 20 20 20 21 21 21 21 21 21 21 21 21 20 20 20 20 20
20 20 20 20 20 21 21 21 21 21 21 21 21 21 20 21 21 21 21 21 21 21 21 21 20 20 20 20 20 20
20 20 20 20 20 20 21 21 21 21 21 21 21 21 21 21 21 21 21 21 21 21 21 20 20 20 20 20 20 20
20 20 20 20 20 20 20 21 21 21 21 21 21 21 21 21 21 21 21 21 21 21 20 20 20 20 20 20 20 20
20 20 20 20 20 20 20 20 21 21 21 21 21 21 21 21 21 21 21 21 21 20 20 20 20 20 20 20 20 20
20 20 20 20 20 20 20 20 20 21 21 21 21 21 21 21 21 21 21 21 20 20 20 20 20 20 20 20 20 20
20 20 20 20 20 20 20 20 20 20 20 20 20 20 20 20 20 20 20 20 20 20 20 20 20 20 20 20 20 20
20 20 20 20 20 20 20 20 20 20 20 20 20 20 20 20 20 20 20 20 20 20 20 20 20 20 20 20 20 20